1111111111
0000000100
0000000100
0000000100
1110000000
0000000000
0000000111
0001110000
0000000000
1111111111

1111111111
0000000000
0000000000
0000000000
0000000000
1110000111
0000000000
0000010000
0000000000
1111111111
