1111111111
0000000000
0000000000
0000000000
0000000000
0000000000
0000000000
0000000000
0000000000
1111111111

1111111111
0000000000
0000000000
0000000000
0000000000
0001111000
0000000000
0111111110
0000000000
1111111111

1111111111
0000000000
0000000000
0000000000
0000000000
0000000000
0000000000
0111111110
0000000000
1111111111

1111111111
0000000000
0000000000
0001100000
0000000000
0000001111
0000000000
1110000000
0000000000
1111111111

1111111111
0000000100
0000000100
0000000100
1110000000
0000000000
0000000111
0001110000
0000000000
1111111111

1111111111
0000000000
0000000000
0000000000
0000000000
1110000111
0000000000
0000010000
0000000000
1111111111

1111111111
0000000000
0000000000
0000000000
0000000000
0000000000
1010101010
1010101010
1010101010
1111111111

1111111111
0000000000
0000000000
0000000000
0000110000
0000000000
1110000111
1110000111
1110000111
1111111111
